1111111111111111111
1P00C00000C0000C001
1000000000000000001
1C0000C00000C000001
1000C111111000E0001
1111111111111111111
