1111111111111111
1100000000C00E01
10000P0000000001
100000000C000001
1111111111111111